13 13
.......E.....
.FFFFFFFFFFF.
.FFFFHFFFFFF.
.LFFFFFFFFFF.
.FFFFFFFFFFF.
.FFFFFFFFFFH.
.FFFFFFSFFFF.
.FFFFFFFFFFF.
.FFFFFFFFFFF.
.FFFFFFFFFFF.
.FFFFCFFFFFF.
.FFFFFFFFFFF.
.............