13 13
.......E.....
.RGGRRTFRRTG.
.RTTRHFFRRTT.
.LTTRRRFRRRT.
.FFTTRRFRRRT.
.FFFFRRFRRTH.
.FFFFFFSFRFF.
.FTTFFFFFFFF.
.TTTTFFFTTFF.
.TTTTFFFTTTF.
.RTTRCFFFTTF.
.RRRRRRFFFFF.
.............