13 13
.......E.....
.FFFFFFFFFFF.
.FFFFHTTTFFF.
.LFFFFFFFFFF.
.FFFFFFFFFFF.
.FFTFFFFFFFH.
.FFFFFFSFFFF.
.FFFFFFFFFFF.
.FFFFFFFFFFF.
.FFFFFFFFFFF.
.FFFFCFFFFFF.
.FFFFFFFFFFF.
.............