13 13
.......E.....
.SSSSSFSFSSS.
.FFFFHTTTFFF.
.LFFFFFFFFFF.
.HFFFFFFFFFF.
.FFTFFFFFFFH.
.FFFFFFSFFFF.
.FFFFFFFFFFF.
.FFFFFFFFFFF.
.FFFFFFFFFFF.
.FFFFCFFFFFF.
.FFFFFFFFFFF.
.............